10
5	17	0	0	0	25	17	0	0	0	
5	23	0	0	0	25	10	0	0	0	
5	10	0	0	0	25	23	0	0	0	
2	13	0	0	0	29	13	0	0	0	
2	20	0	0	0	29	8	0	0	0	
3	20	1.57	0	0	31	8	-1.57	0	0	
2	25	-1.57	0	0	28	8	1.57	0	0	
4	20	0	0	0	25	20	0	0	0	
3	10	0	0	0	25	10	0	0	0	
26	20	-1.57	0	0	10	10	0	0	0	